10
10
1111111111
1000000001
1000000001
1000000001
1000000001
1000000001
1000001101
1000001101
1e00000001
1111111111
