30
30
111111111111111111111111111111
100000000000000000000000000001
100000000000000000000000000001
100000000000000000000000000001
100000000000000000000000000001
100000000000000000000000000001
100000000000000000000000000001
100000000000000000000000000001
100000000000000000000000000001
100000000000000000000000000001
100000000000000000000000000001
100000001101100000000000000001
100000001101100000000000000001
100000001101100000000000000001
100000001101100000000000000001
100000001101100000000000000001
100000001101100000000000000001
100000001000100000000000000001
100000001000100000000000000001
100000001000100000000000000001
100000001000100000000000000001
100000001000100000000000000001
100000001000100000000000000001
100000001000100000000000000001
100000001000100000000000100001
100000000000000000000000000001
100000000000000000000000001101
100000000000000000000000001101
1e0000000000000000000000000001
111111111111111111111111111111
