30
30
333333333333333333333333333333
300000000000000000000000000003
300000000000000000000000000003
300000000000000000000000000003
300000000000000000000000000003
300000000000000000000000000003
300000000000000000000000000003
300000000000000000000000000003
300000000000000000000000000003
300000000000000000000000000003
300000000000000000000000000003
300000001101100000000000000003
300000001101100000000000000003
300000001101100000000000000003
300000001101100000000000000003
300000001101100000000000000003
300000001101100000000000000003
300000001000100000000000000003
300000001000100000000000000003
300000001000100000000000000003
300000001000100000000000000003
300000001000100000000000000003
300000001000100000000000000003
300000001000100000000000000003
300000001000100000000000200003
300000000000000000000000000003
300000000000000000000000002203
300000000000000000000000002203
3e0000000000000000000000000003
333333333333333333333333333333
